++++++++
+     ++
+  +   +
++ +++++
+     S+
+ ++++++
+       
++++++++
